..XXXXXX..
XXX.o.XXX
X..o..o..X
X........X
XXX....XXX
..XX.CXX..
.XXXC.XXX.
.X.CP.C.X.
.X......X.
.XXXXXXXX.